


55555555555
55555555555
55555555555
++++555++++
+55+***+55+
+  +   +  +
+  +   +  +
+    5    +
+    5    +
+    5    +
+         +
+55 555 55+
+55+++++55+   
