

00000000000

000++++++++

00000000000

++++++++000

00000000000

000++++++++

00000000000

++++++++000
