


44444444444

444++++++++

44444444444

++++++++444

44444444444

444++++++++

44444444444

++++++++444
