


 *********
 111111111  
 111111111
 111111111
 111111111  
